sWWWWWW..W.WWWs
        .W..W..
WWW W W WWW.W.W
W...W W       .
..WWW W.WWW  W.
W.... WWW.W. W.
W.WW    W.WW W.
W.W. WW W    WW
s..  ......W.W.
WWW .WW.WW WWW.
W.W WWW        
W.....W.W.W.WW 
W.WWW.WWW.W.W  
....W.....W.W W
WWW.W.WWW.W.W f