SXXXXXX..X.XXXS
        .X..X..
XXX X X XXX.X.X
X...X X       .
..XXX X.XXX  X.
X.... XXX.X. X.
X.XX    X.XX X.
X.X. XX X    XX
S..  ......X.X.
XXX .XX.XX XXX.
X.X XXX        
X.....X.X.X.XX 
X.XXX.XXX.X.X  
....X.....X.X X
XXX.X.XXX.X.X F